111111111111111
1C010000000C101
100001111100001
1P0011E00000101
101011011110101
100000C00000001
111111111111111