111111111111111111111111111111
10C000000000000000000000000001
101001010C100000101001000E0001
101001001010101000100100000001
1P00000000000000000C0000000001
111111111111111111111111111111
